# FILE DATA
id : NXMP1902008040
metadata : {}

# SENTENCE DATA
id : NWRW1800000048.259
metadata : {}


# id : NWRW1800000048.259.1.1
“국가교육위원회 설립 곧바로 나서자”

“국가교육위원회	“/SS+국가교육위원회/NNP
설립	설립/NNG
곧바로	곧바로/MAG
나서자”	나서/VV+자/EF+”/SS


# id : NWRW1800000048.259.2.1
새정치 교육특위 ‘개혁포럼’에서

새정치	새정치/NNP
교육특위	교육/NNG+특위/NNG
‘개혁포럼’에서	‘/SS+개혁/NNG+포럼/NNG+’/SS+에서/JKB


# id : NWRW1800000048.259.3.1
“범국민적 협의기구를” 목소리

“범국민적	“/SS+범/XPN+국민/NNG+적/XSN
협의기구를”	협의/NNG+기구/NNG+를/JKO+”/SS
목소리	목소리/NNG


# id : NWRW1800000048.259.4.1
지난 20년간 한국 교육의 토대가 돼온 1995년 ‘5·31 교육체제’의 대안을 마련하기 위한 사회적 협의기구로 ‘국가교육위원회’를 설립하자는 목소리에 힘이 실리고 있다.

지난	지나/VV+ㄴ/ETM
20년간	20/SN+년/NNB+간/XSN
한국	한국/NNP
교육의	교육/NNG+의/JKG
토대가	토대/NNG+가/JKC
돼온	되/VV+어/EC+오/VX+ㄴ/ETM
1995년	1995/SN+년/NNB
‘5·31	‘/SS+5/SN+·/SP+31/SN
교육체제’의	교육/NNG+체제/NNG+’/SS+의/JKG
대안을	대안/NNG+을/JKO
마련하기	마련/NNG+하/XSV+기/ETN
위한	위하/VV+ㄴ/ETM
사회적	사회/NNG+적/XSN
협의기구로	협의/NNG+기구/NNG+로/JKB
‘국가교육위원회’를	‘/SS+국가교육위원회/NNP+’/SS+를/JKO
설립하자는	설립/NNG+하/XSV+자는/ETM
목소리에	목소리/NNG+에/JKB
힘이	힘/NNG+이/JKS
실리고	실리/VV+고/EC
있다.	있/VX+다/EF+./SF


# id : NWRW1800000048.259.4.2
입시경쟁, 암기, 지식 편중 등으로 상징되는 ‘5·31 교육체제’를 두고 한편에서 신자유주의 교육이라는 비판이 제기돼왔다.

입시경쟁,	입시/NNG+경쟁/NNG+,/SP
암기,	암기/NNG+,/SP
지식	지식/NNG
편중	편중/NNG
등으로	등/NNB+으로/JKB
상징되는	상징/NNG+되/XSV+는/ETM
‘5·31	‘/SS+5/SN+·/SP+31/SN
교육체제’를	교육/NNG+체제/NNG+’/SS+를/JKO
두고	두/VV+고/EC
한편에서	한편/NNG+에서/JKB
신자유주의	신/XPN+자유주의/NNG
교육이라는	교육/NNG+이/VCP+라는/ETM
비판이	비판/NNG+이/JKS
제기돼왔다.	제기/NNG+되/XSV+어/EC+오/VX+았/EP+다/EF+./SF


# id : NWRW1800000048.259.5.1
21일 새정치민주연합 교육특별위원회 주최로 국회의원회관에서 열린 ‘5·31 교육개혁, 신자유주의를 넘어서 미래로’ 포럼에 토론자로 나선 권태선 허핑턴포스트코리아 고문은 “새로운 교육 정책을 입안하기 위해 이념적 대립을 넘어설 수 있는 사회적 기구가 필요하다는 의견이 지지를 얻고 있다”며 “국가교육위원회 문제를 실천 단계로 진입시켜야 할 시점”이라고 말했다.

21일	21/SN+일/NNB
새정치민주연합	새정치민주연합/NNP
교육특별위원회	교육/NNG+특별/NNG+위원회/NNG
주최로	주최/NNG+로/JKB
국회의원회관에서	국회의원회관/NNP+에서/JKB
열린	열리/VV+ㄴ/ETM
‘5·31	‘/SS+5/SN+·/SP+31/SN
교육개혁,	교육/NNG+개혁/NNG+,/SP
신자유주의를	신/XPN+자유주의/NNG+를/JKO
넘어서	넘/VV+어서/EC
미래로’	미래/NNG+로/JKB+’/SS
포럼에	포럼/NNG+에/JKB
토론자로	토론자/NNG+로/JKB
나선	나서/VV+ㄴ/ETM
권태선	권태선/NNP
허핑턴포스트코리아	허핑턴포스트코리아/NNP
고문은	고문/NNG+은/JX
“새로운	“/SS+새롭/VA+ㄴ/ETM
교육	교육/NNG
정책을	정책/NNG+을/JKO
입안하기	입안/NNG+하/XSV+기/ETN
위해	위하/VV+아/EC
이념적	이념/NNG+적/XSN
대립을	대립/NNG+을/JKO
넘어설	넘어서/VV+ㄹ/ETM
수	수/NNB
있는	있/VA+는/ETM
사회적	사회/NNG+적/XSN
기구가	기구/NNG+가/JKS
필요하다는	필요/NNG+하/XSA+다는/ETM
의견이	의견/NNG+이/JKS
지지를	지지/NNG+를/JKO
얻고	얻/VV+고/EC
있다”며	있/VX+다/EF+”/SS+며/EC
“국가교육위원회	“/SS+국가교육위원회/NNP
문제를	문제/NNG+를/JKO
실천	실천/NNG
단계로	단계/NNG+로/JKB
진입시켜야	진입/NNG+시키/XSV+어야/EC
할	하/VX+ㄹ/ETM
시점”이라고	시점/NNG+”/SS+이라고/JKQ
말했다.	말/NNG+하/XSV+았/EP+다/EF+./SF


# id : NWRW1800000048.259.6.1
권 고문은 원유철 새누리당 정책위 의장이 ‘공동체 의식, 잠재력과 소질’을 강조한 점(<한겨레> 12일치 8면)을 상기시키며 “우리 교육이 가야 할 방향에 대한 인식은 진보든 보수든 크게 다른 것 같지 않다”고 진단했다.

권	권/NNP
고문은	고문/NNG+은/JX
원유철	원유철/NNP
새누리당	새누리당/NNP
정책위	정책위/NNG
의장이	의장/NNG+이/JKS
‘공동체	‘/SS+공동체/NNG
의식,	의식/NNG+,/SP
잠재력과	잠재력/NNG+과/JC
소질’을	소질/NNG+’/SS+을/JKO
강조한	강조/NNG+하/XSV+ㄴ/ETM
점(<한겨레>	점/NNG+(/SS+</SS+한겨레/NNP+>/SS
12일치	12/SN+일/NNB+치/NNB
8면)을	8/SN+면/NNG+)/SS+을/JKO
상기시키며	상기/NNG+시키/XSV+며/EC
“우리	“/SS+우리/NP
교육이	교육/NNG+이/JKS
가야	가/VV+아야/EC
할	하/VX+ㄹ/ETM
방향에	방향/NNG+에/JKB
대한	대하/VV+ㄴ/ETM
인식은	인식/NNG+은/JX
진보든	진보/NNG+든/JX
보수든	보수/NNG+든/JX
크게	크/VA+게/EC
다른	다르/VA+ㄴ/ETM
것	것/NNB
같지	같/VA+지/EC
않다”고	않/VX+다/EF+”/SS+고/JKQ
진단했다.	진단/NNG+하/XSV+았/EP+다/EF+./SF


# id : NWRW1800000048.259.6.2
이어 “소모적 갈등과 고통을 줄이겠다는 의지가 있다면 박근혜 정부에서, 지금부터 위원회 구성 준비를 시작하자”고 제안했다.

이어	이어/MAG
“소모적	“/SS+소모/NNG+적/XSN
갈등과	갈등/NNG+과/JC
고통을	고통/NNG+을/JKO
줄이겠다는	줄이/VV+겠/EP+다는/ETM
의지가	의지/NNG+가/JKS
있다면	있/VA+다면/EC
박근혜	박근혜/NNP
정부에서,	정부/NNG+에서/JKB+,/SP
지금부터	지금/NNG+부터/JX
위원회	위원회/NNG
구성	구성/NNG
준비를	준비/NNG+를/JKO
시작하자”고	시작/NNG+하/XSV+자/EF+”/SS+고/JKQ
제안했다.	제안/NNG+하/XSV+았/EP+다/EF+./SF


# id : NWRW1800000048.259.6.3
권 고문은 국가교육위를 독립기구로 하되, 교육계의 폭넓은 추천을 받아 위원을 뽑고 임기를 10년 정도로 정해 정치 간섭을 배제할 필요가 있다고 짚었다.

권	권/NNP
고문은	고문/NNG+은/JX
국가교육위를	국가교육위/NNP+를/JKO
독립기구로	독립/NNG+기구/NNG+로/JKB
하되,	하/VV+되/EC+,/SP
교육계의	교육/NNG+계/XSN+의/JKG
폭넓은	폭넓/VA+은/ETM
추천을	추천/NNG+을/JKO
받아	받/VV+아/EC
위원을	위원/NNG+을/JKO
뽑고	뽑/VV+고/EC
임기를	임기/NNG+를/JKO
10년	10/SN+년/NNB
정도로	정도/NNG+로/JKB
정해	정하/VV+아/EC
정치	정치/NNG
간섭을	간섭/NNG+을/JKO
배제할	배제/NNG+하/XSV+ㄹ/ETM
필요가	필요/NNG+가/JKS
있다고	있/VA+다고/EC
짚었다.	짚/VV+었/EP+다/EF+./SF


# id : NWRW1800000048.259.7.1
최교진 세종시교육감도 “새로운 교육담론을 정립하려면 범국민적 사회적 협의기구 가동이 시급하다”며 공감을 나타냈다.

최교진	최교진/NNP
세종시교육감도	세종시/NNP+교육감/NNG+도/JX
“새로운	“/SS+새롭/VA+ㄴ/ETM
교육담론을	교육/NNG+담론/NNG+을/JKO
정립하려면	정립/NNG+하/XSV+려면/EC
범국민적	범/XPN+국민/NNG+적/XSN
사회적	사회/NNG+적/XSN
협의기구	협의/NNG+기구/NNG
가동이	가동/NNG+이/JKS
시급하다”며	시급하/VA+다/EF+”/SS+며/EC
공감을	공감/NNG+을/JKO
나타냈다.	나타내/VV+었/EP+다/EF+./SF


# id : NWRW1800000048.259.7.2
도종환 새정치민주연합 의원은 “5·31 이후 20년간 지속된 신자유주의 교육에 제대로 대응했는가 반성한다”며 “국가교육위를 포함한 정책 설계를 통해, 경쟁 위주인 5·31 교육체제를 세월호 사건을 계기로 협력과 생명을 중시하는 4·16 교육체제로 전환할 대안을 논의하자”고 말했다.

도종환	도종환/NNP
새정치민주연합	새정치민주연합/NNP
의원은	의원/NNG+은/JX
“5·31	“/SS+5/SN+·/SP+31/SN
이후	이후/NNG
20년간	20/SN+년/NNB+간/XSN
지속된	지속/NNG+되/XSV+ㄴ/ETM
신자유주의	신/XPN+자유주의/NNG
교육에	교육/NNG+에/JKB
제대로	제대로/MAG
대응했는가	대응/NNG+하/XSV+았/EP+는가/EF
반성한다”며	반성/NNG+하/XSV+ㄴ다/EF+”/SS+며/EC
“국가교육위를	“/SS+국가교육위/NNP+를/JKO
포함한	포함/NNG+하/XSV+ㄴ/ETM
정책	정책/NNG
설계를	설계/NNG+를/JKO
통해,	통하/VV+아/EC+,/SP
경쟁	경쟁/NNG
위주인	위주/NNG+이/VCP+ㄴ/ETM
5·31	5/SN+·/SP+31/SN
교육체제를	교육/NNG+체제/NNG+를/JKO
세월호	세월호/NNP
사건을	사건/NNG+을/JKO
계기로	계기/NNG+로/JKB
협력과	협력/NNG+과/JC
생명을	생명/NNG+을/JKO
중시하는	중시/NNG+하/XSV+는/ETM
4·16	4/SN+·/SP+16/SN
교육체제로	교육/NNG+체제/NNG+로/JKB
전환할	전환/NNG+하/XSV+ㄹ/ETM
대안을	대안/NNG+을/JKO
논의하자”고	논의/NNG+하/XSV+자/EF+”/SS+고/JKQ
말했다.	말/NNG+하/XSV+았/EP+다/EF+./SF


# id : NWRW1800000048.259.8.1
반면 이찬승 ‘교육을 바꾸는 사람들’ 대표는 “5·31만 탓하거나 국가교육위로 모든 문제를 풀려는 건 잘못된 통념”이라며 “점수로 평가·측정하는 표준화가 (한국 교육 문제의) 뿌리라는 점을 놓쳐선 안 된다”는 의견을 냈다.

반면	반면/NNG
이찬승	이찬승/NNP
‘교육을	‘/SS+교육/NNG+을/JKO
바꾸는	바꾸/VV+는/ETM
사람들’	사람/NNG+들/XSN+’/SS
대표는	대표/NNG+는/JX
“5·31만	“/SS+5/SN+·/SP+31/SN+만/JX
탓하거나	탓/NNG+하/XSV+거나/EC
국가교육위로	국가교육위/NNP+로/JKB
모든	모든/MMN
문제를	문제/NNG+를/JKO
풀려는	풀/VV+려는/ETM
건	거/NNB+ㄴ/JX
잘못된	잘못/MAG+되/XSV+ㄴ/ETM
통념”이라며	통념/NNG+”/SS+이/VCP+라며/EC
“점수로	“/SS+점수/NNG+로/JKB
평가·측정하는	평가/NNG+·/SP+측정/NNG+하/XSV+는/ETM
표준화가	표준/NNG+화/XSN+가/JKS
(한국	(/SS+한국/NNP
교육	교육/NNG
문제의)	문제/NNG+의/JKG+)/SS
뿌리라는	뿌리/NNG+이/VCP+라는/ETM
점을	점/NNG+을/JKO
놓쳐선	놓치/VV+어서/EC+ㄴ/JX
안	안/MAG
된다”는	되/VV+ㄴ다/EF+”/SS+는/ETM
의견을	의견/NNG+을/JKO
냈다.	내/VV+었/EP+다/EF+./SF


# id : NWRW1800000048.259.9.1
5·31 방안을 마련할 때 전문위원으로 참여했던 윤여각 한국방송통신대 교수(교육학)는 “당시 외국 사람들의 논의를 가져다 적용했고, 개혁 주체여야 할 교사들의 제안은 묻혔다”며 우리 교육개혁 사례와 사람에 주목할 것을 주문했다.

5·31	5/SN+·/SP+31/SN
방안을	방안/NNG+을/JKO
마련할	마련/NNG+하/XSV+ㄹ/ETM
때	때/NNG
전문위원으로	전문/NNG+위원/NNG+으로/JKB
참여했던	참여/NNG+하/XSV+았/EP+던/ETM
윤여각	윤여각/NNP
한국방송통신대	한국방송통신대/NNP
교수(교육학)는	교수/NNG+(/SS+교육학/NNG+)/SS+는/JX
“당시	“/SS+당시/NNG
외국	외국/NNG
사람들의	사람/NNG+들/XSN+의/JKG
논의를	논의/NNG+를/JKO
가져다	가지/VV+어다/EC
적용했고,	적용/NNG+하/XSV+았/EP+고/EC+,/SP
개혁	개혁/NNG
주체여야	주체/NNG+이/VCP+어야/EC
할	하/VX+ㄹ/ETM
교사들의	교사/NNG+들/XSN+의/JKG
제안은	제안/NNG+은/JX
묻혔다”며	묻히/VV+었/EP+다/EF+”/SS+며/EC
우리	우리/NP
교육개혁	교육/NNG+개혁/NNG
사례와	사례/NNG+와/JC
사람에	사람/NNG+에/JKB
주목할	주목/NNG+하/XSV+ㄹ/ETM
것을	것/NNB+을/JKO
주문했다.	주문/NNG+하/XSV+았/EP+다/EF+./SF


# id : NWRW1800000048.259.9.2
새정치연합 교육특위(공동위원장 김태년 유기홍 의원)는 앞으로 대안 모색, 의제 개발을 거쳐 정책을 확정할 예정이다.

새정치연합	새정치연합/NNP
교육특위(공동위원장	교육/NNG+특위/NNG+(/SS+공동/NNG+위원장/NNG
김태년	김태년/NNP
유기홍	유기홍/NNP
의원)는	의원/NNG+)/SS+는/JX
앞으로	앞/NNG+으로/JKB
대안	대안/NNG
모색,	모색/NNG+,/SP
의제	의제/NNG
개발을	개발/NNG+을/JKO
거쳐	거치/VV+어/EC
정책을	정책/NNG+을/JKO
확정할	확정/NNG+하/XSV+ㄹ/ETM
예정이다.	예정/NNG+이/VCP+다/EF+./SF


