# FILE DATA
id : NXMP1902008040
metadata : {}

# SENTENCE DATA
id : NWRW1800000024.443
metadata : {}


# id : NWRW1800000024.443.1.1
출구 없는 ‘패권 중독증’…미국의 화근

출구	출구/NNG
없는	없/VA+는/ETM
‘패권	‘/SS+패권/NNG
중독증’…미국의	중독증/NNG+’/SS+…/SE+미국/NNP+의/JKG
화근	화근/NNG


# id : NWRW1800000024.443.2.1
제국의 몰락- 미국의 패권은 어떻게 무너지는가 가브리엘 콜코 지음·지소철 옮김/비아북·1만4500원 미국의 실패와 몰락을 다룬 담론들은 이제 새삼스러울 게 없을 지경이 됐지만, 가브리엘 콜코(77) 캐나다 요크대 명예교수의 새 책 <제국의 몰락>은 그 주제를 달리 보게 만드는 중량감이 있다.

제국의	제국/NNG+의/JKG
몰락-	몰락/NNG+-/SO
미국의	미국/NNP+의/JKG
패권은	패권/NNG+은/JX
어떻게	어떻/VA+게/EC
무너지는가	무너지/VV+는가/EF
가브리엘	가브리엘/NNP
콜코	콜코/NNP
지음·지소철	짓/VV+음/ETN+·/SP+지소철/NNP
옮김/비아북·1만4500원	옮기/VV+ㅁ/ETN+//SP+비아북/NNP+·/SP+1/SN+만/NR+4500/SN+원/NNB
실패와	실패/NNG+와/JC
몰락을	몰락/NNG+을/JKO
다룬	다루/VV+ㄴ/ETM
담론들은	담론/NNG+들/XSN+은/JX
이제	이제/MAG
새삼스러울	새삼/MAG+스럽/XSA+ㄹ/ETM
게	거/NNB+이/JKS
없을	없/VA+을/ETM
지경이	지경/NNB+이/JKC
됐지만,	되/VV+었/EP+지만/EC+,/SP
콜코(77)	콜코/NNP+(/SS+77/SN+)/SS
캐나다	캐나다/NNP
요크대	요크대/NNP
명예교수의	명예/NNG+교수/NNG+의/JKG
새	새/MMA
책	책/NNG
<제국의	</SS+제국/NNG+의/JKG
몰락>은	몰락/NNG+>/SS+은/JX
그	그/MMD
주제를	주제/NNG+를/JKO
달리	달리/MAG
보게	보/VV+게/EC
만드는	만들/VV+는/ETM
중량감이	중량감/NNG+이/JKS
있다.	있/VA+다/EF+./SF


# id : NWRW1800000024.443.3.1
미국의 초기 신좌파(뉴레프트)를 이끈 수정주의 역사가로, <한국전쟁의 기원>을 쓴 브루스 커밍스 등에게 큰 영향을 준 것으로 알려진 콜코의 책에 붙은 원래 제목은 ‘위기에 처한 세계- 미국 세기의 종언’(World in Crisis: The End of the American Century)이다.

미국의	미국/NNP+의/JKG
초기	초기/NNG
신좌파(뉴레프트)를	신/XPN+좌파/NNG+(/SS+뉴레프트/NNG+)/SS+를/JKO
이끈	이끌/VV+ㄴ/ETM
수정주의	수정주의/NNG
역사가로,	역사가/NNG+로/JKB+,/SP
<한국전쟁의	</SS+한국/NNP+전쟁/NNG+의/JKG
기원>을	기원/NNG+>/SS+을/JKO
쓴	쓰/VV+ㄴ/ETM
브루스	브루스/NNP
커밍스	커밍스/NNP
등에게	등/NNB+에게/JKB
큰	크/VA+ㄴ/ETM
영향을	영향/NNG+을/JKO
준	주/VV+ㄴ/ETM
것으로	것/NNB+으로/JKB
알려진	알려지/VV+ㄴ/ETM
콜코의	콜코/NNP+의/JKG
책에	책/NNG+에/JKB
붙은	붙/VV+은/ETM
원래	원래/NNG
제목은	제목/NNG+은/JX
‘위기에	‘/SS+위기/NNG+에/JKB
처한	처하/VV+ㄴ/ETM
세계-	세계/NNG+-/SO
미국	미국/NNP
세기의	세기/NNG+의/JKG
종언’(World	종언/NNG+’/SS+(/SS+World/SL
in	in/SL
Crisis:	Crisis/SL+:/SP
The	The/SL
End	End/SL
of	of/SL
the	the/SL
American	American/SL
Century)이다.	Century/SL+)/SS+이/VCP+다/EF+./SF


# id : NWRW1800000024.443.3.2
이는 이 책이 비중있게 다루는 도널드 럼스펠드 전 국방장관 등의 네오콘(신보수주의)적 세계관에 대한 야유로도 들린다.

이는	이/NP+는/JX
이	이/MMD
책이	책/NNG+이/JKS
비중있게	비중/NNG+있/VA+게/EC
다루는	다루/VV+는/ETM
도널드	도널드/NNP
럼스펠드	럼스펠드/NNP
전	전/MMD
국방장관	국방/NNG+장관/NNG
등의	등/NNB+의/JKG
네오콘(신보수주의)적	네오콘/NNG+(/SS+신/XPN+보수주의/NNG+)/SS+적/XSN
세계관에	세계관/NNG+에/JKB
대한	대하/VV+ㄴ/ETM
야유로도	야유/NNG+로/JKB+도/JX
들린다.	들리/VV+ㄴ다/EF+./SF


# id : NWRW1800000024.443.3.3
미국의 세기가 끝났다고 했을 때 콜코는 <위클리 스탠더드>를 운영한 네오콘의 이론가 윌리엄 크리스톨이나 로버트 케이건이 주도한 싱크탱크 ‘새로운 미국의 세기를 위한 프로젝트’(Project for the New American Century)를 염두에 두지 않았을까.

미국의	미국/NNP+의/JKG
세기가	세기/NNG+가/JKS
끝났다고	끝나/VV+았/EP+다고/EC
했을	하/VV+았/EP+을/ETM
때	때/NNG
콜코는	콜코/NNP+는/JX
<위클리	</SS+위클리/NNP
스탠더드>를	스탠더드/NNP+>/SS+를/JKO
운영한	운영/NNG+하/XSV+ㄴ/ETM
네오콘의	네오콘/NNG+의/JKG
이론가	이론가/NNG
윌리엄	윌리엄/NNP
크리스톨이나	크리스톨/NNP+이나/JC
로버트	로버트/NNP
케이건이	케이건/NNP+이/JKS
주도한	주도/NNG+하/XSV+ㄴ/ETM
싱크탱크	싱크탱크/NNG
‘새로운	‘/SS+새롭/VA+ㄴ/ETM
세기를	세기/NNG+를/JKO
위한	위하/VV+ㄴ/ETM
프로젝트’(Project	프로젝트/NNG+’/SS+(/SS+Project/SL
for	for/SL
the	the/SL
New	New/SL
American	American/SL
Century)를	Century/SL+)/SS+를/JKO
염두에	염두/NNG+에/JKB
두지	두/VV+지/EC
않았을까.	않/VX+았/EP+을까/EF+./SF


# id : NWRW1800000024.443.3.4
2001년 9·11사태 이후 아프가니스탄과 이라크 침공, ‘테러와의 전쟁’ 선포 등을 거치면서 세계를 압도하듯 기세등등했던 미국의 ‘새로운’ 세기는 부시의 짧았던 치세와 더불어 그야말로 신기루처럼 사라져가고 있다.

2001년	2001/SN+년/NNB
9·11사태	9/SN+·/SP+11/SN+사태/NNG
이후	이후/NNG
아프가니스탄과	아프가니스탄/NNP+과/JKB
이라크	이라크/NNP
침공,	침공/NNG+,/SP
‘테러와의	‘/SS+테러/NNG+와/JKB+의/JKG
전쟁’	전쟁/NNG+’/SS
선포	선포/NNG
등을	등/NNB+을/JKO
거치면서	거치/VV+면서/EC
세계를	세계/NNG+를/JKO
압도하듯	압도/NNG+하/XSV+듯/EC
기세등등했던	기세등등/MAG+하/XSA+았/EP+던/ETM
미국의	미국/NNP+의/JKG
‘새로운’	‘/SS+새롭/VA+ㄴ/ETM+’/SS
세기는	세기/NNG+는/JX
부시의	부시/NNP+의/JKG
짧았던	짧/VA+았/EP+던/ETM
치세와	치세/NNG+와/JKB
더불어	더불/VV+어/EC
그야말로	그야말로/MAG
신기루처럼	신기루/NNG+처럼/JKB
사라져가고	사라지/VV+어/EC+가/VX+고/EC
있다.	있/VX+다/EF+./SF


# id : NWRW1800000024.443.3.5
“미국의 리더십은 미국만이 아니라 세계에도 좋다”며 “우리 편이 아니면 적”을 외치던 그들의 위세와 오만은 옛말이 됐다.

“미국의	“/SS+미국/NNP+의/JKG
리더십은	리더십/NNG+은/JX
미국만이	미국/NNP+만/JX+이/JKC
아니라	아니/VCN+라/EC
세계에도	세계/NNG+에/JKB+도/JX
좋다”며	좋/VA+다/EF+”/SS+며/EC
“우리	“/SS+우리/NP
편이	편/NNG+이/JKC
아니면	아니/VCN+면/EC
적”을	적/NNG+”/SS+을/JKO
외치던	외치/VV+던/ETM
그들의	그/NP+들/XSN+의/JKG
위세와	위세/NNG+와/JC
오만은	오만/NNG+은/JX
옛말이	옛말/NNG+이/JKC
됐다.	되/VV+었/EP+다/EF+./SF


# id : NWRW1800000024.443.4.1
콜코는 미국의 실패와 몰락을 크게 세가지 방향에서 살핀다.

콜코는	콜코/NNP+는/JX
미국의	미국/NNP+의/JKG
실패와	실패/NNG+와/JC
몰락을	몰락/NNG+을/JKO
크게	크/VA+게/EC
세가지	세/MMN+가지/NNB
방향에서	방향/NNG+에서/JKB
살핀다.	살피/VV+ㄴ다/EF+./SF


# id : NWRW1800000024.443.4.2
하나는 서브프라임 모기지(비우량 주택담보대출) 부실화를 계기로 적나라하게 그 모순을 드러낸 미국경제의 금융투기자본주의화.

하나는	하나/NR+는/JX
서브프라임	서브프라임/NNG
모기지(비우량	모기지/NNG+(/SS+비/XPN+우량/NNG
주택담보대출)	주택/NNG+담보/NNG+대출/NNG+)/SS
부실화를	부실/NNG+화/XSN+를/JKO
계기로	계기/NNG+로/JKB
적나라하게	적나라하/VA+게/EC
그	그/MMD
모순을	모순/NNG+을/JKO
드러낸	드러내/VV+ㄴ/ETM
미국경제의	미국/NNP+경제/NNG+의/JKG
금융투기자본주의화.	금융/NNG+투기/NNG+자본주의/NNG+화/XSN+./SF


# id : NWRW1800000024.443.4.3
세계화와 ‘워싱턴 컨센서스’를 무기로 한 신자유주의정책은 미국 등 강국들의 자본이 파생금융상품 등을 앞세워 경제적 약자들로부터 일시적으로 막대한 이윤을 뽑아올릴 수 있게 만들어주었지만 탈규제와 자유화가 통제불능 상태로 치달아 자본주의 자체를 자살로 이끌고 있다는 게 콜코의 생각이다.

세계화와	세계/NNG+화/XSN+와/JKB
‘워싱턴	‘/SS+워싱턴/NNP
컨센서스’를	컨센서스/NNG+’/SS+를/JKO
무기로	무기/NNG+로/JKB
한	하/VV+ㄴ/ETM
신자유주의정책은	신/XPN+자유주의/NNG+정책/NNG+은/JX
미국	미국/NNP
등	등/NNB
강국들의	강국/NNG+들/XSN+의/JKG
자본이	자본/NNG+이/JKS
파생금융상품	파생/NNG+금융/NNG+상품/NNG
등을	등/NNB+을/JKO
앞세워	앞세우/VV+어/EC
경제적	경제/NNG+적/XSN
약자들로부터	약자/NNG+들/XSN+로부터/JKB
일시적으로	일시/NNG+적/XSN+으로/JKB
막대한	막대하/VA+ㄴ/ETM
이윤을	이윤/NNG+을/JKO
뽑아올릴	뽑/VV+아/EC+올리/VV+ㄹ/ETM
수	수/NNB
있게	있/VA+게/EC
만들어주었지만	만들/VV+어/EC+주/VX+었/EP+지만/EC
탈규제와	탈/XPN+규제/NNG+와/JC
자유화가	자유/NNG+화/XSN+가/JKS
통제불능	통제/NNG+불능/NNG
상태로	상태/NNG+로/JKB
치달아	치닫/VV+아/EC
자본주의	자본주의/NNG
자체를	자체/NNG+를/JKO
자살로	자살/NNG+로/JKB
이끌고	이끌/VV+고/EC
있다는	있/VX+다는/ETM
게	거/NNB+이/JKS
콜코의	콜코/NNP+의/JKG
생각이다.	생각/NNG+이/VCP+다/EF+./SF


# id : NWRW1800000024.443.5.1
또 하나는 신무기 개발에 집착하는 군사주의.

또	또/MAG
하나는	하나/NR+는/JX
신무기	신/XPN+무기/NNG
개발에	개발/NNG+에/JKB
집착하는	집착/NNG+하/XSV+는/ETM
군사주의.	군사주의/NNG+./SF


# id : NWRW1800000024.443.5.2
원래 소련과 바르샤바조약기구 동맹국들과의 전면전에 대비해 집중화된 목표물을 파괴할 목적으로 개발된 미국의 무기체계는 미군이 처음으로 승리할 수 없었던 한국전쟁 때부터 문제를 드러내기 시작했다.

원래	원래/MAG
소련과	소련/NNP+과/JC
바르샤바조약기구	바르샤바조약기구/NNP
동맹국들과의	동맹국/NNG+들/XSN+과/JKB+의/JKG
전면전에	전면전/NNG+에/JKB
대비해	대비/NNG+하/XSV+아/EC
집중화된	집중/NNG+화/XSN+되/XSV+ㄴ/ETM
목표물을	목표물/NNG+을/JKO
파괴할	파괴/NNG+하/XSV+ㄹ/ETM
목적으로	목적/NNG+으로/JKB
개발된	개발/NNG+되/XSV+ㄴ/ETM
미국의	미국/NNP+의/JKG
무기체계는	무기/NNG+체계/NNG+는/JX
미군이	미군/NNG+이/JKS
처음으로	처음/NNG+으로/JKB
승리할	승리/NNG+하/XSV+ㄹ/ETM
수	수/NNB
없었던	없/VA+었/EP+던/ETM
한국전쟁	한국/NNP+전쟁/NNG
때부터	때/NNG+부터/JX
문제를	문제/NNG+를/JKO
드러내기	드러내/VV+기/ETN
시작했다.	시작/NNG+하/XSV+았/EP+다/EF+./SF


# id : NWRW1800000024.443.5.3
그리고 베트남전, 최근의 아프간·이라크 침공에 이르기까지 게릴라전에서 모조리 미국에 패배를 안겼다.

그리고	그리고/MAJ
베트남전,	베트남전/NNG+,/SP
최근의	최근/NNG+의/JKG
아프간·이라크	아프간/NNP+·/SP+이라크/NNP
침공에	침공/NNG+에/JKB
이르기까지	이르/VV+기/ETN+까지/JX
게릴라전에서	게릴라전/NNG+에서/JKB
모조리	모조리/MAG
미국에	미국/NNP+에/JKB
패배를	패배/NNG+를/JKO
안겼다.	안기/VV+었/EP+다/EF+./SF


# id : NWRW1800000024.443.6.1
뿐만 아니라 핵무기를 비롯해 크루즈 미사일, 견착식 대공미사일 등 최첨단 무기들에 대한 미국의 독점적 우위는 최근의 급속한 기술발전에 따라 급속히 무너지고 있다.

뿐만	뿐/NNB+만/JX
아니라	아니/VCN+라/EC
핵무기를	핵무기/NNG+를/JKO
비롯해	비롯하/VV+아/EC
크루즈	크루즈/NNG
미사일,	미사일/NNG+,/SP
견착식	견착식/NNG
대공미사일	대공/NNG+미사일/NNG
등	등/NNB
최첨단	최/XPN+첨단/NNG
무기들에	무기/NNG+들/XSN+에/JKB
대한	대하/VV+ㄴ/ETM
미국의	미국/NNP+의/JKG
독점적	독점/NNG+적/XSN
우위는	우위/NNG+는/JX
최근의	최근/NNG+의/JKG
급속한	급속/NNG+하/XSA+ㄴ/ETM
기술발전에	기술/NNG+발전/NNG+에/JKB
따라	따르/VV+아/EC
급속히	급속히/MAG
무너지고	무너지/VV+고/EC
있다.	있/VX+다/EF+./SF


# id : NWRW1800000024.443.6.2
예컨대 2006년 이스라엘이 기습작전을 펼친 제2차 레바논전쟁에서 미국제 첨단무기와 통신망으로 무장한 이스라엘군은 사상 처음으로 헤즈볼라 저항군에게 사실상 패배했다.

예컨대	예컨대/MAG
2006년	2006/SN+년/NNB
이스라엘이	이스라엘/NNP+이/JKS
기습작전을	기습/NNG+작전/NNG+을/JKO
펼친	펼치/VV+ㄴ/ETM
제2차	제/XPN+2/SN+차/NNB
레바논전쟁에서	레바논/NNP+전쟁/NNG+에서/JKB
미국제	미국제/NNG
첨단무기와	첨단/NNG+무기/NNG+와/JC
통신망으로	통신망/NNG+으로/JKB
무장한	무장/NNG+하/XSV+ㄴ/ETM
이스라엘군은	이스라엘군/NNG+은/JX
사상	사상/NNG
처음으로	처음/NNG+으로/JKB
헤즈볼라	헤즈볼라/NNP
저항군에게	저항군/NNG+에게/JKB
사실상	사실/NNG+상/XSN
패배했다.	패배/NNG+하/XSV+았/EP+다/EF+./SF


# id : NWRW1800000024.443.6.3
헤즈볼라 쪽도 러시아와 중국제 첨단무기로 무장했을 뿐 아니라 통신감청 기술은 부패와 오직, 사기저하로 휘청거리는 이스라엘군을 오히려 능가했다.

헤즈볼라	헤즈볼라/NNP
쪽도	쪽/NNB+도/JX
러시아와	러시아/NNP+와/JC
중국제	중국제/NNG
첨단무기로	첨단/NNG+무기/NNG+로/JKB
무장했을	무장/NNG+하/XSV+았/EP+을/ETM
뿐	뿐/NNB
아니라	아니/VCN+라/EC
통신감청	통신/NNG+감청/NNG
기술은	기술/NNG+은/JX
부패와	부패/NNG+와/JC
오직,	오직/MAG+,/SP
사기저하로	사기/NNG+저하/NNG+로/JKB
휘청거리는	휘청거리/VV+는/ETM
이스라엘군을	이스라엘군/NNG+을/JKO
오히려	오히려/MAG
능가했다.	능가/NNG+하/XSV+았/EP+다/EF+./SF


# id : NWRW1800000024.443.6.4
이스라엘 첨단 메르카바 탱크 20여대가 헤즈볼라의 대전차 로켓에 당했다.

이스라엘	이스라엘/NNP
첨단	첨단/NNG
메르카바	메르카바/NNP
탱크	탱크/NNG
20여대가	20/SN+여/XSN+대/NNB+가/JKS
헤즈볼라의	헤즈볼라/NNP+의/JKG
대전차	대전차/NNG
로켓에	로켓/NNG+에/JKB
당했다.	당하/VV+았/EP+다/EF+./SF


# id : NWRW1800000024.443.6.5
콜코가 보기에 미국이 이란을 공격할 경우 미국의 항공모함을 비롯한 함정과 전투기들은 안전을 보장받지 못한다.

콜코가	콜코/NNP+가/JKS
보기에	보/VV+기/ETN+에/JKB
미국이	미국/NNP+이/JKS
이란을	이란/NNP+을/JKO
공격할	공격/NNG+하/XSV+ㄹ/ETM
경우	경우/NNG
미국의	미국/NNP+의/JKG
항공모함을	항공/NNG+모함/NNG+을/JKO
비롯한	비롯하/VV+ㄴ/ETM
함정과	함정/NNG+과/JC
전투기들은	전투기/NNG+들/XSN+은/JX
안전을	안전/NNG+을/JKO
보장받지	보장/NNG+받/XSV+지/EC
못한다.	못하/VX+ㄴ다/EF+./SF


# id : NWRW1800000024.443.6.6
이는 일시적 현상이 아니라 항상적 현상이다.

이는	이/NP+는/JX
일시적	일시/NNG+적/XSN
현상이	현상/NNG+이/JKC
아니라	아니/VCN+라/EC
항상적	항상/MAG+적/XSN
현상이다.	현상/NNG+이/VCP+다/EF+./SF


# id : NWRW1800000024.443.6.7
이젠 누구나 쉽고 싸게 첨단무기들, 심지어 핵무기까지 입수해 활용할 수 있다.

이젠	이제/NNG+ㄴ/JX
누구나	누구/NP+나/JX
쉽고	쉽/VA+고/EC
싸게	싸/VA+게/EC
첨단무기들,	첨단/NNG+무기/NNG+들/XSN+,/SP
심지어	심지어/MAG
핵무기까지	핵무기/NNG+까지/JX
입수해	입수/NNG+하/XSV+아/EC
활용할	활용/NNG+하/XSV+ㄹ/ETM
수	수/NNB
있다.	있/VA+다/EF+./SF


# id : NWRW1800000024.443.6.8
파괴력의 ‘민주화’ ‘평준화’다.

파괴력의	파괴력/NNG+의/JKG
‘민주화’	‘/SS+민주/NNG+화/XSN+’/SS
‘평준화’다.	‘/SS+평준/NNG+화/XSN+’/SS+이/VCP+다/EF+./SF


# id : NWRW1800000024.443.6.9
미국은 장차 첨단무기로 무장한 정체불명의 적들과 미국 영토내에서 싸워야 할지 모른다.

미국은	미국/NNP+은/JX
장차	장차/MAG
첨단무기로	첨단/NNG+무기/NNG+로/JKB
무장한	무장/NNG+하/XSV+ㄴ/ETM
정체불명의	정체불명/NNG+의/JKG
적들과	적/NNG+들/XSN+과/JC
미국	미국/NNP
영토내에서	영토/NNG+내/NNB+에서/JKB
싸워야	싸우/VV+어야/EC
할지	하/VX+ㄹ지/EC
모른다.	모르/VV+ㄴ다/EF+./SF


# id : NWRW1800000024.443.7.1
하지만 콜코는 미국의 실패를 부시와 공화당, 네오콘 탓으로만 돌려선 안 된다고 말한다.

하지만	하지만/MAJ
콜코는	콜코/NNP+는/JX
미국의	미국/NNP+의/JKG
실패를	실패/NNG+를/JKO
부시와	부시/NNP+와/JC
공화당,	공화당/NNP+,/SP
네오콘	네오콘/NNG
탓으로만	탓/NNG+으로/JKB+만/JX
돌려선	돌리/VV+어서/EC+ㄴ/JX
안	안/MAG
된다고	되/VV+ㄴ다고/EC
말한다.	말/NNG+하/XSV+ㄴ다/EF+./SF


# id : NWRW1800000024.443.7.2
미국의 실패는 2차 세계대전 직후인 1947년 3월, 그리스와 터키의 ‘좌파’혁명 위기를 과장하면서 냉전의 깃발을 올리고 미국의 패권을 위해 제3세계 등 외부세계에 깊숙이 관여하기 시작한 트루먼 독트린 때부터 본격화했다.

미국의	미국/NNP+의/JKG
실패는	실패/NNG+는/JX
2차	2/SN+차/NNB
세계대전	세계/NNG+대전/NNG
직후인	직후/NNG+이/VCP+ㄴ/ETM
1947년	1947/SN+년/NNB
3월,	3/SN+월/NNB+,/SP
그리스와	그리스/NNP+와/JC
터키의	터키/NNP+의/JKG
‘좌파’혁명	‘/SS+좌파/NNG+’/SS+혁명/NNG
위기를	위기/NNG+를/JKO
과장하면서	과장/NNG+하/XSV+면서/EC
냉전의	냉전/NNG+의/JKG
깃발을	깃발/NNG+을/JKO
올리고	올리/VV+고/EC
패권을	패권/NNG+을/JKO
위해	위하/VV+아/EC
제3세계	제/XPN+3/SN+세계/NNG
등	등/NNB
외부세계에	외부/NNG+세계/NNG+에/JKB
깊숙이	깊숙이/MAG
관여하기	관여/NNG+하/XSV+기/ETN
시작한	시작/NNG+하/XSV+ㄴ/ETM
트루먼	트루먼/NNP
독트린	독트린/NNG
때부터	때/NNG+부터/JX
본격화했다.	본격/NNG+화/XSN+하/XSV+았/EP+다/EF+./SF


# id : NWRW1800000024.443.7.3
미국은 그때부터 이미 방향을 잘못 잡았고 그러지 않았다면 도래했을지도 모를 신세계 창출 역량을 소진하고 말았다.

미국은	미국/NNP+은/JX
그때부터	그때/NNG+부터/JX
이미	이미/MAG
방향을	방향/NNG+을/JKO
잘못	잘못/MAG
잡았고	잡/VV+았/EP+고/EC
그러지	그러/VV+지/EC
않았다면	않/VX+았/EP+다면/EC
도래했을지도	도래/NNG+하/XSV+았/EP+을지/EC+도/JX
모를	모르/VV+ㄹ/ETM
신세계	신/XPN+세계/NNG
창출	창출/NNG
역량을	역량/NNG+을/JKO
소진하고	소진/NNG+하/XSV+고/EC
말았다.	말/VX+았/EP+다/EF+./SF


# id : NWRW1800000024.443.7.4
“1947년 미국이 은밀하게, 때로는 공개적으로 그 많은 정권들(미국은 위협적이라고 생각했지만 사실 대부분이 중립적이고 개혁적이고 합법적이었다을 전복하려 하지 않았다면 오늘날 미국이 그토록 걱정스러워하는 극단주의자들은 훨씬 적었을 것이다.”

“1947년	“/SS+1947/SN+년/NNB
미국이	미국/NNP+이/JKS
은밀하게,	은밀하/VA+게/EC+,/SP
때로는	때로/MAG+는/JX
공개적으로	공개/NNG+적/XSN+으로/JKB
그	그/MMD
많은	많/VA+은/ETM
정권들(미국은	정권/NNG+들/XSN+(/SS+미국/NNP+은/JX
위협적이라고	위협/NNG+적/XSN+이/VCP+라고/EC
생각했지만	생각/NNG+하/XSV+았/EP+지만/EC
사실	사실/MAG
대부분이	대/XPN+부분/NNG+이/JKS
중립적이고	중립/NNG+적/XSN+이/VCP+고/EC
개혁적이고	개혁/NNG+적/XSN+이/VCP+고/EC
합법적이었다을	합법/NNG+적/XSN+이/VCP+었/EP+다/EF+을/JKO
전복하려	전복/NNG+하/XSV+려/EC
하지	하/VX+지/EC
않았다면	않/VX+았/EP+다면/EC
오늘날	오늘날/NNG
그토록	그토록/MAG
걱정스러워하는	걱정/NNG+스럽/XSA+어/EC+하/VX+는/ETM
극단주의자들은	극단주의자/NNG+들/XSN+은/JX
훨씬	훨씬/MAG
적었을	적/VA+었/EP+을/ETM
것이다.”	것/NNB+이/VCP+다/EF+./SF+”/SS


# id : NWRW1800000024.443.7.5
트루먼이 민주당이었지만 이런 공세적 대외정책을 펴는 데 공화당과 민주당이 다르지 않았다.

트루먼이	트루먼/NNP+이/JKS
민주당이었지만	민주당/NNP+이/VCP+었/EP+지만/EC
이런	이런/MMD
공세적	공세/NNG+적/XSN
대외정책을	대외/NNG+정책/NNG+을/JKO
펴는	펴/VV+는/ETM
데	데/NNB
공화당과	공화당/NNP+과/JKB
민주당이	민주당/NNP+이/JKS
다르지	다르/VA+지/EC
않았다.	않/VX+았/EP+다/EF+./SF


# id : NWRW1800000024.443.7.6
그리고 부드러움으로 위장한 조지프 나이류의 민주당식 소프트파워가 실은 더 위험할 수도 있다고 콜코는 지적한다.

그리고	그리고/MAJ
부드러움으로	부드럽/VA+ㅁ/ETN+으로/JKB
위장한	위장/NNG+하/XSV+ㄴ/ETM
조지프	조지프/NNP
나이류의	나이/NNP+류/XSN+의/JKG
민주당식	민주당식/NNG
소프트파워가	소프트파워/NNG+가/JKS
실은	실은/MAG
더	더/MAG
위험할	위험/NNG+하/XSA+ㄹ/ETM
수도	수/NNB+도/JX
있다고	있/VA+다고/EC
콜코는	콜코/NNP+는/JX
지적한다.	지적/NNG+하/XSV+ㄴ다/EF+./SF


# id : NWRW1800000024.443.8.1
이런 대외 개입주의가 콜코의 세번째 접근 포인트.

이런	이런/MMD
대외	대외/NNG
개입주의가	개입/NNG+주의/NNG+가/JKS
콜코의	콜코/NNP+의/JKG
세번째	세/MMN+번/NNB+째/XSN
접근	접근/NNG
포인트.	포인트/NNG+./SF


# id : NWRW1800000024.443.8.2
지금 미국이 당면한 대외문제 가운데 가장 중대한 문제는 이슬람세계와의 갈등이다.

지금	지금/MAG
미국이	미국/NNP+이/JKS
당면한	당면/NNG+하/XSV+ㄴ/ETM
대외문제	대외/NNG+문제/NNG
가운데	가운데/NNG
가장	가장/MAG
중대한	중대/NNG+하/XSA+ㄴ/ETM
문제는	문제/NNG+는/JX
이슬람세계와의	이슬람/NNG+세계/NNG+와/JKB+의/JKG
갈등이다.	갈등/NNG+이/VCP+다/EF+./SF


# id : NWRW1800000024.443.8.3
이 문제는 1차 세계대전 뒤 해체된 오스만터키를 유럽 제국주의국가들이 자신들에게 유리하게 마음대로 갈라놓고 그 한복판에 자신들의 헤게모니를 관철하기 위한 일종의 유럽 위성국 이스라엘을 만들어놓은 게 화근이다.

이	이/MMD
문제는	문제/NNG+는/JX
1차	1/SN+차/NNB
세계대전	세계/NNG+대전/NNG
뒤	뒤/NNG
해체된	해체/NNG+되/XSV+ㄴ/ETM
오스만터키를	오스만/NNP+터키/NNP+를/JKO
유럽	유럽/NNP
제국주의국가들이	제국주의/NNG+국가/NNG+들/XSN+이/JKS
자신들에게	자신/NNG+들/XSN+에게/JKB
유리하게	유리/NNG+하/XSA+게/EC
마음대로	마음대로/MAG
갈라놓고	갈라놓/VV+고/EC
그	그/MMD
한복판에	한/XPN+복판/NNG+에/JKB
자신들의	자신/NNG+들/XSN+의/JKG
헤게모니를	헤게모니/NNG+를/JKO
관철하기	관철/NNG+하/XSV+기/ETN
위한	위하/VV+ㄴ/ETM
일종의	일종/NNG+의/JKG
위성국	위성국/NNG
이스라엘을	이스라엘/NNP+을/JKO
만들어놓은	만들/VV+어/EC+놓/VX+은/ETM
게	거/NNB+이/JKS
화근이다.	화근/NNG+이/VCP+다/EF+./SF


# id : NWRW1800000024.443.9.1
콜코가 볼 때 이스라엘이 아랍국들과의 대결정책을 고수하는 한 출구가 없다.

콜코가	콜코/NNP+가/JKS
볼	보/VV+ㄹ/ETM
때	때/NNG
이스라엘이	이스라엘/NNP+이/JKS
아랍국들과의	아랍국/NNG+들/XSN+과/JKB+의/JKG
대결정책을	대결/NNG+정책/NNG+을/JKO
고수하는	고수/NNG+하/XSV+는/ETM
한	한/NNG
출구가	출구/NNG+가/JKS
없다.	없/VA+다/EF+./SF


# id : NWRW1800000024.443.9.2
이스라엘은 앞으로 무력 우위를 급속히 상실해갈 것이며 전쟁 스트레스 속에 고급 인력들 중심으로 해외이민이 급증하면서 인구학적으로도 불리해질 수밖에 없어 화해 없는 대결은 이스라엘 쪽의 비극으로 끝나게 될 공산이 크다.

이스라엘은	이스라엘/NNP+은/JX
앞으로	앞/NNG+으로/JKB
무력	무력/NNG
우위를	우위/NNG+를/JKO
급속히	급속히/MAG
상실해갈	상실/NNG+하/XSV+아/EC+가/VX+ㄹ/ETM
것이며	것/NNB+이/VCP+며/EC
전쟁	전쟁/NNG
스트레스	스트레스/NNG
속에	속/NNG+에/JKB
고급	고급/NNG
인력들	인력/NNG+들/XSN
중심으로	중심/NNG+으로/JKB
해외이민이	해외/NNG+이민/NNG+이/JKS
급증하면서	급증/NNG+하/XSV+면서/EC
인구학적으로도	인구학/NNG+적/XSN+으로/JKB+도/JX
불리해질	불리/NNG+하/XSA+아/EC+지/VX+ㄹ/ETM
수밖에	수/NNB+밖에/JX
없어	없/VA+어/EC
화해	화해/NNG
없는	없/VA+는/ETM
대결은	대결/NNG+은/JX
이스라엘	이스라엘/NNP
쪽의	쪽/NNB+의/JKG
비극으로	비극/NNG+으로/JKB
끝나게	끝나/VV+게/EC
될	되/VV+ㄹ/ETM
공산이	공산/NNG+이/JKS
크다.	크/VA+다/EF+./SF


# id : NWRW1800000024.443.9.3
석유 국유화를 도모한 이란의 모사데그 민족주의정권을 영국과 합작해 전복하고, 사담 후세인을 지원해 시아파의 이란과 전쟁을 벌이게 했으며, 아프간에선 소련을 무너뜨리기 위해 탈레반을 키웠던 미국의 중동공작이 앞으로 성공할 가능성은 거의 없다.

석유	석유/NNG
국유화를	국유/NNG+화/XSN+를/JKO
도모한	도모/NNG+하/XSV+ㄴ/ETM
이란의	이란/NNP+의/JKG
모사데그	모사데그/NNP
민족주의정권을	민족주의/NNG+정권/NNG+을/JKO
영국과	영국/NNP+과/JKB
합작해	합작/NNG+하/XSV+아/EC
전복하고,	전복/NNG+하/XSV+고/EC+,/SP
사담	사담/NNP
후세인을	후세인/NNP+을/JKO
지원해	지원/NNG+하/XSV+아/EC
시아파의	시아파/NNG+의/JKG
이란과	이란/NNP+과/JKB
전쟁을	전쟁/NNG+을/JKO
벌이게	벌이/VV+게/EC
했으며,	하/VX+았/EP+으며/EC+,/SP
아프간에선	아프간/NNP+에서/JKB+ㄴ/JX
소련을	소련/NNP+을/JKO
무너뜨리기	무너뜨리/VV+기/ETN
위해	위하/VV+아/EC
탈레반을	탈레반/NNP+을/JKO
키웠던	키우/VV+었/EP+던/ETM
미국의	미국/NNP+의/JKG
중동공작이	중동/NNP+공작/NNG+이/JKS
앞으로	앞/NNG+으로/JKB
성공할	성공/NNG+하/XSV+ㄹ/ETM
가능성은	가능/NNG+성/XSN+은/JX
거의	거의/MAG
없다.	없/VA+다/EF+./SF


# id : NWRW1800000024.443.9.4
아프간·이라크 침공은 석유 가격을 올려놓아 결과적으로 미국이 가장 꺼려온 이란의 중동내 영향력을 오히려 압도적으로 키우는 역효과만 낳았다.

아프간·이라크	아프간/NNP+·/SP+이라크/NNP
침공은	침공/NNG+은/JX
석유	석유/NNG
가격을	가격/NNG+을/JKO
올려놓아	올려놓/VV+아/EC
결과적으로	결과/NNG+적/XSN+으로/JKB
미국이	미국/NNP+이/JKS
가장	가장/MAG
꺼려온	꺼리/VV+어/EC+오/VX+ㄴ/ETM
이란의	이란/NNP+의/JKG
중동내	중동/NNP+내/NNB
영향력을	영향력/NNG+을/JKO
오히려	오히려/MAG
압도적으로	압도/NNG+적/XSN+으로/JKB
키우는	키우/VV+는/ETM
역효과만	역효과/NNG+만/JX
낳았다.	낳/VV+았/EP+다/EF+./SF


# id : NWRW1800000024.443.9.5
미국은 이란을 공격할 여력이 없다.

미국은	미국/NNP+은/JX
이란을	이란/NNP+을/JKO
공격할	공격/NNG+하/XSV+ㄹ/ETM
여력이	여력/NNG+이/JKS
없다.	없/VA+다/EF+./SF


# id : NWRW1800000024.443.10.1
콜코는 1949년에 출범한 북대서양조약기구(나토)도 미국이 유럽의 독자세력화를 막고 자국에 복속시키기 위해 만든 것이며, 소련과 그 동맹체제의 위협이나 반공주의는 구실에 지나지 않았다고 지적한다.

콜코는	콜코/NNP+는/JX
1949년에	1949/SN+년/NNB+에/JKB
출범한	출범/NNG+하/XSV+ㄴ/ETM
북대서양조약기구(나토)도	북대서양조약기구/NNP+(/SS+나토/NNP+)/SS+도/JX
미국이	미국/NNP+이/JKS
유럽의	유럽/NNP+의/JKG
독자세력화를	독자/NNG+세력/NNG+화/XSN+를/JKO
막고	막/VV+고/EC
자국에	자국/NNG+에/JKB
복속시키기	복속/NNG+시키/XSV+기/ETN
위해	위하/VV+아/EC
만든	만들/VV+ㄴ/ETM
것이며,	것/NNB+이/VCP+며/EC+,/SP
소련과	소련/NNP+과/JC
그	그/MMD
동맹체제의	동맹/NNG+체제/NNG+의/JKG
위협이나	위협/NNG+이나/JC
반공주의는	반공주의/NNG+는/JX
구실에	구실/NNG+에/JKB
지나지	지나/VV+지/EC
않았다고	않/VX+았/EP+다고/EC
지적한다.	지적/NNG+하/XSV+ㄴ다/EF+./SF


# id : NWRW1800000024.443.10.2
마치 해방공간에서 친일파들의 반공주의가 자신들의 범죄행위를 숨기고 정적들을 제거하기 위한 구실에 지나지 않았듯이.

마치	마치/MAG
해방공간에서	해방/NNG+공간/NNG+에서/JKB
친일파들의	친일파/NNG+들/XSN+의/JKG
반공주의가	반공주의/NNG+가/JKS
자신들의	자신/NNG+들/XSN+의/JKG
범죄행위를	범죄/NNG+행위/NNG+를/JKO
숨기고	숨기/VV+고/EC
정적들을	정적/NNG+들/XSN+을/JKO
제거하기	제거/NNG+하/XSV+기/ETN
위한	위하/VV+ㄴ/ETM
구실에	구실/NNG+에/JKB
지나지	지나/VV+지/EC
않았듯이.	않/VX+았/EP+듯이/EC+./SF


# id : NWRW1800000024.443.10.3
그 나토도 유럽과의 이해대립으로 조만간 해체될 것으로 콜코는 본다.

그	그/MMD
나토도	나토/NNP+도/JX
유럽과의	유럽/NNP+과/JKB+의/JKG
이해대립으로	이해/NNG+대립/NNG+으로/JKB
조만간	조만간/MAG
해체될	해체/NNG+되/XSV+ㄹ/ETM
것으로	것/NNB+으로/JKB
콜코는	콜코/NNP+는/JX
본다.	보/VV+ㄴ다/EF+./SF


# id : NWRW1800000024.443.10.4
동맹해체와 전쟁 포기가 해법이다.

동맹해체와	동맹/NNG+해체/NNG+와/JC
전쟁	전쟁/NNG
포기가	포기/NNG+가/JKS
해법이다.	해법/NNG+이/VCP+다/EF+./SF


# id : NWRW1800000024.443.11.1
냉전붕괴 뒤 적들의 부재 속에 방만한 금융투기와 막대한 재정·무역적자를 조장하고, 군산복합체와 출세주의·기회주의에 사로잡힌 정치적 야심가들만 살찌워 놓은 채 전 세계를 동반자살로 몰아가는 미국.

냉전붕괴	냉전/NNG+붕괴/NNG
뒤	뒤/NNG
적들의	적/NNG+들/XSN+의/JKG
부재	부재/NNG
속에	속/NNG+에/JKB
방만한	방만하/VA+ㄴ/ETM
금융투기와	금융/NNG+투기/NNG+와/JC
막대한	막대하/VA+ㄴ/ETM
재정·무역적자를	재정/NNG+·/SP+무역/NNG+적자/NNG+를/JKO
조장하고,	조장/NNG+하/XSV+고/EC+,/SP
군산복합체와	군산/NNG+복합체/NNG+와/JC
출세주의·기회주의에	출세주의/NNG+·/SP+기회주의/NNG+에/JKB
사로잡힌	사로잡히/VV+ㄴ/ETM
정치적	정치/NNG+적/XSN
야심가들만	야심가/NNG+들/XSN+만/JX
살찌워	살찌우/VV+어/EC
놓은	놓/VX+은/ETM
채	채/NNB
전	전/MMN
세계를	세계/NNG+를/JKO
동반자살로	동반/NNG+자살/NNG+로/JKB
몰아가는	몰아가/VV+는/ETM
미국.	미국/NNP+./SF


# id : NWRW1800000024.443.11.2
콜코는 기존 사회주의와 자본주의 이후를 모색해야 한다고 말한다.

콜코는	콜코/NNP+는/JX
기존	기존/NNG
사회주의와	사회주의/NNG+와/JC
자본주의	자본주의/NNG
이후를	이후/NNG+를/JKO
모색해야	모색/NNG+하/XSV+아야/EC
한다고	하/VX+ㄴ다고/EC
말한다.	말/NNG+하/XSV+ㄴ다/EF+./SF


