# FILE DATA
id : NXMP1902008040
metadata : {}

# SENTENCE DATA
id : NWRW1800000028.366
metadata : {}


# id : NWRW1800000028.366.1.1
“방통심의위 ‘인터넷 관제 검열기구’로 전락

“방통심의위	“/SS+방통심의위/NNG
‘인터넷	‘/SS+인터넷/NNG
관제	관제/NNG
검열기구’로	검열/NNG+기구/NNG+’/SS+로/JKB
전락	전락/NNG


# id : NWRW1800000028.366.2.1
‘민간 자율 심의기구’를 내건 방송통신심의위원회(방통심의위)가 사실상 국가의 인터넷 검열기구라는 지적이 국가기관에서 제기되며 존립 근거가 뿌리부터 흔들리고 있다.

‘민간	‘/SS+민간/NNG
자율	자율/NNG
심의기구’를	심의/NNG+기구/NNG+’/SS+를/JKO
내건	내걸/VV+ㄴ/ETM
방송통신심의위원회(방통심의위)가	방송/NNG+통신/NNG+심의/NNG+위원회/NNG+(/SS+방통심의위/NNG+)/SS+가/JKS
사실상	사실/NNG+상/XSN
국가의	국가/NNG+의/JKG
인터넷	인터넷/NNG
검열기구라는	검열/NNG+기구/NNG+이/VCP+라는/ETM
지적이	지적/NNG+이/JKS
국가기관에서	국가/NNG+기관/NNG+에서/JKB
제기되며	제기/NNG+되/XSV+며/EC
존립	존립/NNG
근거가	근거/NNG+가/JKS
뿌리부터	뿌리/NNG+부터/JX
흔들리고	흔들리/VV+고/EC
있다.	있/VX+다/EF+./SF


# id : NWRW1800000028.366.3.1
국가인권위는 지난 18일 보도자료를 내어 “(방통심의위를 통한) 현행 정보통신 심의제도가 행정기관이 인터넷을 통제하고 사실상 검열로 기능할 위험이 높아 인터넷의 표현 자유를 중대하게 침해할 우려가 있다”며 “인터넷 정보에 대한 방통심의위의 권한을 민간자율기구에 이양하라고 방송통신위원장에게 권고하는 결정을 내렸다”고 밝혔다.

국가인권위는	국가인권위/NNP+는/JX
지난	지나/VV+ㄴ/ETM
18일	18/SN+일/NNB
보도자료를	보도/NNG+자료/NNG+를/JKO
내어	내/VV+어/EC
“(방통심의위를	“/SS+(/SS+방통심의위/NNG+를/JKO
통한)	통하/VV+ㄴ/ETM+)/SS
현행	현행/NNG
정보통신	정보/NNG+통신/NNG
심의제도가	심의/NNG+제도/NNG+가/JKS
행정기관이	행정/NNG+기관/NNG+이/JKS
인터넷을	인터넷/NNG+을/JKO
통제하고	통제/NNG+하/XSV+고/EC
사실상	사실/NNG+상/XSN
검열로	검열/NNG+로/JKB
기능할	기능/NNG+하/XSV+ㄹ/ETM
위험이	위험/NNG+이/JKS
높아	높/VA+아/EC
인터넷의	인터넷/NNG+의/JKG
표현	표현/NNG
자유를	자유/NNG+를/JKO
중대하게	중대/NNG+하/XSA+게/EC
침해할	침해/NNG+하/XSV+ㄹ/ETM
우려가	우려/NNG+가/JKS
있다”며	있/VA+다/EF+”/SS+며/EC
“인터넷	“/SS+인터넷/NNG
정보에	정보/NNG+에/JKB
대한	대하/VV+ㄴ/ETM
방통심의위의	방통심의위/NNG+의/JKG
권한을	권한/NNG+을/JKO
민간자율기구에	민간/NNG+자율/NNG+기구/NNG+에/JKB
이양하라고	이양/NNG+하/XSV+라고/EC
방송통신위원장에게	방송/NNG+통신/NNG+위원장/NNG+에게/JKB
권고하는	권고/NNG+하/XSV+는/ETM
결정을	결정/NNG+을/JKO
내렸다”고	내리/VV+었/EP+다/EF+”/SS+고/JKQ
밝혔다.	밝히/VV+었/EP+다/EF+./SF


# id : NWRW1800000028.366.4.1
국가인권위는 현행 심의제도는 인터넷 게시글을 삭제할 때 게시자에게 미리 알려주거나 의견을 낼 기회도 주지 않아, 적법하지 않고 표현 자유도 침해한다고 밝혔다.

국가인권위는	국가인권위/NNP+는/JX
현행	현행/NNG
심의제도는	심의/NNG+제도/NNG+는/JX
인터넷	인터넷/NNG
게시글을	게시/NNG+글/NNG+을/JKO
삭제할	삭제/NNG+하/XSV+ㄹ/ETM
때	때/NNG
게시자에게	게시자/NNG+에게/JKB
미리	미리/MAG
알려주거나	알리/VV+어/EC+주/VX+거나/EC
의견을	의견/NNG+을/JKO
낼	내/VV+ㄹ/ETM
기회도	기회/NNG+도/JX
주지	주/VV+지/EC
않아,	않/VX+아/EC+,/SP
적법하지	적법/NNG+하/XSA+지/EC
않고	않/VX+고/EC
표현	표현/NNG
자유도	자유/NNG+도/JX
침해한다고	침해/NNG+하/XSV+ㄴ다고/EC
밝혔다.	밝히/VV+었/EP+다/EF+./SF


# id : NWRW1800000028.366.4.2
국가인권위는 이 결정에서 ‘방통심의위가 행정기구가 아닌 민간 자율기구이며 포털사업자가 그 권고를 자발적으로 수용하고 있을 뿐’이라는 정부와 방통심의위의 주장을 정면으로 반박했다.

국가인권위는	국가인권위/NNP+는/JX
이	이/MMD
결정에서	결정/NNG+에서/JKB
‘방통심의위가	‘/SS+방통심의위/NNG+가/JKS
행정기구가	행정/NNG+기구/NNG+가/JKC
아닌	아니/VCN+ㄴ/ETM
민간	민간/NNG
자율기구이며	자율/NNG+기구/NNG+이/VCP+며/EC
포털사업자가	포털/NNG+사업자/NNG+가/JKS
그	그/MMD
권고를	권고/NNG+를/JKO
자발적으로	자발/NNG+적/XSN+으로/JKB
수용하고	수용/NNG+하/XSV+고/EC
있을	있/VX+을/ETM
뿐’이라는	뿐/NNB+’/SS+이/VCP+라는/ETM
정부와	정부/NNG+와/JC
방통심의위의	방통심의위/NNG+의/JKG
주장을	주장/NNG+을/JKO
정면으로	정면/NNG+으로/JKB
반박했다.	반박/NNG+하/XSV+았/EP+다/EF+./SF


# id : NWRW1800000028.366.4.3
국가인권위는 헌법재판소 결정을 인용해 “방통심의위 운영이 대통령령으로 규정돼 있으며, 위원을 대통령이 위촉하고 운영경비를 국가가 지원하기 때문에 실질적인 행정기구”라고 밝혔다.

국가인권위는	국가인권위/NNP+는/JX
헌법재판소	헌법/NNG+재판소/NNG
결정을	결정/NNG+을/JKO
인용해	인용/NNG+하/XSV+아/EC
“방통심의위	“/SS+방통심의위/NNG
운영이	운영/NNG+이/JKS
대통령령으로	대통령령/NNG+으로/JKB
규정돼	규정/NNG+되/XSV+어/EC
있으며,	있/VX+으며/EC+,/SP
위원을	위원/NNG+을/JKO
대통령이	대통령/NNG+이/JKS
위촉하고	위촉/NNG+하/XSV+고/EC
운영경비를	운영/NNG+경비/NNG+를/JKO
국가가	국가/NNG+가/JKS
지원하기	지원/NNG+하/XSV+기/ETN
때문에	때문/NNB+에/JKB
실질적인	실질/NNG+적/XSN+이/VCP+ㄴ/ETM
행정기구”라고	행정/NNG+기구/NNG+”/SS+라고/JKQ
밝혔다.	밝히/VV+었/EP+다/EF+./SF


# id : NWRW1800000028.366.4.4
현행 인터넷 심의제도는 시정요구를 사업자가 거부할 경우 방송통신위원회가 행정명령을 내릴 수 있고 형사처벌도 가능한데, 사전고지 등 적법절차를 갖추지 않고 있다는 점도 지적됐다.

현행	현행/NNG
인터넷	인터넷/NNG
심의제도는	심의/NNG+제도/NNG+는/JX
시정요구를	시정/NNG+요구/NNG+를/JKO
사업자가	사업자/NNG+가/JKS
거부할	거부/NNG+하/XSV+ㄹ/ETM
경우	경우/NNG
방송통신위원회가	방송/NNG+통신/NNG+위원회/NNG+가/JKS
행정명령을	행정/NNG+명령/NNG+을/JKO
내릴	내리/VV+ㄹ/ETM
수	수/NNB
있고	있/VA+고/EC
형사처벌도	형사/NNG+처벌/NNG+도/JX
가능한데,	가능/NNG+하/XSA+ㄴ데/EC+,/SP
사전고지	사전/NNG+고지/NNG
등	등/NNB
적법절차를	적법/NNG+절차/NNG+를/JKO
갖추지	갖추/VV+지/EC
않고	않/VX+고/EC
있다는	있/VX+다는/ETM
점도	점/NNG+도/JX
지적됐다.	지적/NNG+되/XSV+었/EP+다/EF+./SF


# id : NWRW1800000028.366.4.5
인권위는 “심의 기준에 ‘기타 사회적 혼란을 현저히 야기할 우려가 있는 내용’이 포함돼 있다”며 “심의 대상과 기준이 불명확해 행정기관의 자의적 개입을 허용하고 사실상 검열로 기능할 위험이 매우 높다”고 밝혔다.

인권위는	인권위/NNP+는/JX
“심의	“/SS+심의/NNG
기준에	기준/NNG+에/JKB
‘기타	‘/SS+기타/NNG
사회적	사회/NNG+적/XSN
혼란을	혼란/NNG+을/JKO
현저히	현저히/MAG
야기할	야기/NNG+하/XSV+ㄹ/ETM
우려가	우려/NNG+가/JKS
있는	있/VA+는/ETM
내용’이	내용/NNG+’/SS+이/JKS
포함돼	포함/NNG+되/XSV+어/EC
있다”며	있/VX+다/EF+”/SS+며/EC
대상과	대상/NNG+과/JC
기준이	기준/NNG+이/JKS
불명확해	불명확하/VA+아/EC
행정기관의	행정/NNG+기관/NNG+의/JKG
자의적	자의/NNG+적/XSN
개입을	개입/NNG+을/JKO
허용하고	허용/NNG+하/XSV+고/EC
사실상	사실/NNG+상/XSN
검열로	검열/NNG+로/JKB
기능할	기능/NNG+하/XSV+ㄹ/ETM
위험이	위험/NNG+이/JKS
매우	매우/MAG
높다”고	높/VA+다/EF+”/SS+고/JKQ
밝혔다.	밝히/VV+었/EP+다/EF+./SF


# id : NWRW1800000028.366.5.1
방통심의위를 통한 국가기관의 인터넷 검열은 국회 국정감사에서도 도마에 올랐다.

방통심의위를	방통심의위/NNG+를/JKO
통한	통하/VV+ㄴ/ETM
국가기관의	국가/NNG+기관/NNG+의/JKG
인터넷	인터넷/NNG
검열은	검열/NNG+은/JX
국회	국회/NNG
국정감사에서도	국정/NNG+감사/NNG+에서/JKB+도/JX
도마에	도마/NNG+에/JKB
올랐다.	오르/VV+았/EP+다/EF+./SF


# id : NWRW1800000028.366.5.2
최문순 민주당 의원은 19일 열린 방통심의위 국정감사에서 “방통심의위에 대한 정부와 공공기관의 게시글 삭제와 차단 요청이 갈수록 늘어나고 있다”며 “삭제로 이어진 비율도 민간 요청에 비해 월등히 높아, 방통심의위가 사실상 정부의 필요에 따라 게시물을 삭제해주는 정부의 검열집행 대행기관으로 전락했다”고 지적했다.

최문순	최문순/NNP
민주당	민주당/NNP
의원은	의원/NNG+은/JX
19일	19/SN+일/NNB
열린	열리/VV+ㄴ/ETM
방통심의위	방통심의위/NNG
국정감사에서	국정/NNG+감사/NNG+에서/JKB
“방통심의위에	“/SS+방통심의위/NNG+에/JKB
대한	대하/VV+ㄴ/ETM
정부와	정부/NNG+와/JC
공공기관의	공공/NNG+기관/NNG+의/JKG
게시글	게시/NNG+글/NNG
삭제와	삭제/NNG+와/JC
차단	차단/NNG
요청이	요청/NNG+이/JKS
갈수록	갈수록/MAG
늘어나고	늘어나/VV+고/EC
있다”며	있/VX+다/EF+”/SS+며/EC
“삭제로	“/SS+삭제/NNG+로/JKB
이어진	이어지/VV+ㄴ/ETM
비율도	비율/NNG+도/JX
민간	민간/NNG
요청에	요청/NNG+에/JKB
비해	비/NNG+하/XSV+아/EC
월등히	월등히/MAG
높아,	높/VA+아/EC+,/SP
방통심의위가	방통심의위/NNG+가/JKS
사실상	사실/NNG+상/XSN
정부의	정부/NNG+의/JKG
필요에	필요/NNG+에/JKB
따라	따르/VV+아/EC
게시물을	게시물/NNG+을/JKO
삭제해주는	삭제/NNG+하/XSV+아/EC+주/VX+는/ETM
검열집행	검열/NNG+집행/NNG
대행기관으로	대행/NNG+기관/NNG+으로/JKB
전락했다”고	전락/NNG+하/XSV+았/EP+다/EF+”/SS+고/JKQ
지적했다.	지적/NNG+하/XSV+았/EP+다/EF+./SF


# id : NWRW1800000028.366.6.1
방통심의위가 최 의원에게 제출한 자료를 보면, 해마다 2만건이 넘는 인터넷 심의에서 중앙행정기관과 공공기관의 요청이 차지하는 비중은 2008년 14.3%(3183건), 2009년 44.4%(9369건), 2010년 1~7월 59%(7083건)로 갈수록 늘어나고 있다.

방통심의위가	방통심의위/NNG+가/JKS
최	최/NNP
의원에게	의원/NNG+에게/JKB
제출한	제출/NNG+하/XSV+ㄴ/ETM
자료를	자료/NNG+를/JKO
보면,	보/VV+면/EC+,/SP
해마다	해마다/MAG
2만건이	2/SN+만/NR+건/NNB+이/JKS
넘는	넘/VV+는/ETM
인터넷	인터넷/NNG
심의에서	심의/NNG+에서/JKB
중앙행정기관과	중앙/NNG+행정/NNG+기관/NNG+과/JC
공공기관의	공공/NNG+기관/NNG+의/JKG
요청이	요청/NNG+이/JKS
차지하는	차지/NNG+하/XSV+는/ETM
비중은	비중/NNG+은/JX
2008년	2008/SN+년/NNB
14.3%(3183건),	14/SN+./SP+3/SN+%/SW+(/SS+3183/SN+건/NNB+)/SS+,/SP
2009년	2009/SN+년/NNB
44.4%(9369건),	44/SN+./SP+4/SN+%/SW+(/SS+9369/SN+건/NNB+)/SS+,/SP
2010년	2010/SN+년/NNB
1~7월	1/SN+~/SO+7/SN+월/NNB
59%(7083건)로	59/SN+%/SW+(/SS+7083/SN+건/NNB+)/SS+로/JKB
갈수록	갈수록/MAG
늘어나고	늘어나/VV+고/EC
있다.	있/VX+다/EF+./SF


# id : NWRW1800000028.366.6.2
특히 국가정보원, 경찰, 검찰이 삭제요청한 경우에 대한 이행률은 94.7%로, 다른 행정기관의 요청 이행률 63%에 비해 월등히 높았다.

특히	특히/MAG
국가정보원,	국가/NNG+정보원/NNG+,/SP
경찰,	경찰/NNG+,/SP
검찰이	검찰/NNG+이/JKS
삭제요청한	삭제/NNG+요청/NNG+하/XSV+ㄴ/ETM
경우에	경우/NNG+에/JKB
대한	대하/VV+ㄴ/ETM
이행률은	이행/NNG+률/XSN+은/JX
94.7%로,	94/SN+./SP+7/SN+%/SW+로/JKB+,/SP
다른	다른/MMD
행정기관의	행정/NNG+기관/NNG+의/JKG
요청	요청/NNG
이행률	이행/NNG+률/XSN
63%에	63/SN+%/SW+에/JKB
비해	비/NNG+하/XSV+아/EC
월등히	월등히/MAG
높았다.	높/VA+았/EP+다/EF+./SF


