# FILE DATA
id : NXMP1902008040
metadata : {}

# SENTENCE DATA
id : NWRW1800000048.41
metadata : {}


# id : NWRW1800000048.41.1.1
전경련 “베이비붐세대 책임 이행”…대한상의 “학벌중시 사회 개혁을”

전경련	전경련/NNP
“베이비붐세대	“/SS+베이비붐/NNG+세대/NNG
책임	책임/NNG
이행”…대한상의	이행/NNG+”/SS+…/SE+대한상의/NNP
“학벌중시	“/SS+학벌/NNG+중시/NNG
사회	사회/NNG
개혁을”	개혁/NNG+을/JKO+”/SS


# id : NWRW1800000048.41.2.1
청년실업 어떻게 해결할까

청년실업	청년/NNG+실업/NNG
어떻게	어떻/VA+게/EC
해결할까	해결/NNG+하/XSV+ㄹ까/EF


# id : NWRW1800000048.41.3.1
전경련이 갈수록 심해지는 청년실업을 해결하기 위해서는 아버지세대인 베이비붐세대가 자녀세대에 대한 책임 이행(세대간 사회적 책임·ISR)을 해야 한다고 제안했다.

전경련이	전경련/NNP+이/JKS
갈수록	갈수록/MAG
심해지는	심하/VA+아/EC+지/VX+는/ETM
청년실업을	청년/NNG+실업/NNG+을/JKO
해결하기	해결/NNG+하/XSV+기/ETN
위해서는	위하/VV+아서/EC+는/JX
아버지세대인	아버지/NNG+세대/NNG+이/VCP+ㄴ/ETM
베이비붐세대가	베이비붐/NNG+세대/NNG+가/JKS
자녀세대에	자녀/NNG+세대/NNG+에/JKB
대한	대하/VV+ㄴ/ETM
책임	책임/NNG
이행(세대간	이행/NNG+(/SS+세대/NNG+간/NNB
사회적	사회/NNG+적/XSN
책임·ISR)을	책임/NNG+·/SP+ISR/SL+)/SS+을/JKO
해야	하/VV+아야/EC
한다고	하/VX+ㄴ다고/EC
제안했다.	제안/NNG+하/XSV+았/EP+다/EF+./SF


# id : NWRW1800000048.41.3.2
대한상의는 청년실업이 경기불황이나 저성장 같은 경제문제가 아니라 학벌중시사회와 근시안적 교육·노동정책 때문이라고 분석했다.

대한상의는	대한상의/NNP+는/JX
청년실업이	청년/NNG+실업/NNG+이/JKS
경기불황이나	경기/NNG+불황/NNG+이나/JC
저성장	저/XPN+성장/NNG
같은	같/VA+은/ETM
경제문제가	경제/NNG+문제/NNG+가/JKC
아니라	아니/VCN+라/EC
학벌중시사회와	학벌/NNG+중시/NNG+사회/NNG+와/JC
근시안적	근시안/NNG+적/XSN
교육·노동정책	교육/NNG+·/SP+노동/NNG+정책/NNG
때문이라고	때문/NNB+이/VCP+라고/EC
분석했다.	분석/NNG+하/XSV+았/EP+다/EF+./SF


# id : NWRW1800000048.41.4.1
전경련의 이승철 부회장은 29일 기자간담회에서 ‘세대간 사회적 책임’이란 새 개념을 제시하며, “베이비붐세대는 자녀세대에 지속성장을 통한 안정된 미래를 물려주기 위한 경제·사회적 책무가 있다며, 부모세대가 솔선수범해서 해결책을 제시해야 한다”고 말했다.

전경련의	전경련/NNP+의/JKG
이승철	이승철/NNP
부회장은	부회장/NNG+은/JX
29일	29/SN+일/NNB
기자간담회에서	기자/NNG+간담회/NNG+에서/JKB
‘세대간	‘/SS+세대/NNG+간/NNB
사회적	사회/NNG+적/XSN
책임’이란	책임/NNG+’/SS+이/VCP+란/ETM
새	새/MMA
개념을	개념/NNG+을/JKO
제시하며,	제시/NNG+하/XSV+며/EC+,/SP
“베이비붐세대는	“/SS+베이비붐/NNG+세대/NNG+는/JX
자녀세대에	자녀/NNG+세대/NNG+에/JKB
지속성장을	지속/NNG+성장/NNG+을/JKO
통한	통하/VV+ㄴ/ETM
안정된	안정/NNG+되/XSV+ㄴ/ETM
미래를	미래/NNG+를/JKO
물려주기	물려주/VV+기/ETN
위한	위하/VV+ㄴ/ETM
경제·사회적	경제/NNG+·/SP+사회/NNG+적/XSN
책무가	책무/NNG+가/JKS
있다며,	있/VA+다며/EC+,/SP
부모세대가	부모/NNG+세대/NNG+가/JKS
솔선수범해서	솔선수범/NNG+하/XSV+아서/EC
해결책을	해결책/NNG+을/JKO
제시해야	제시/NNG+하/XSV+아야/EC
한다”고	하/VX+ㄴ다/EF+”/SS+고/JKQ
말했다.	말/NNG+하/XSV+았/EP+다/EF+./SF


# id : NWRW1800000048.41.5.1
베이비붐세대는 1955~1963년(52~60살) 출생자를, 자녀세대는 1979~1992년(23~36살) 출생자를 각각 뜻한다.

베이비붐세대는	베이비붐/NNG+세대/NNG+는/JX
1955~1963년(52~60살)	1955/SN+~/SO+1963/SN+년/NNB+(/SS+52/SN+~/SO+60/SN+살/NNB+)/SS
출생자를,	출생자/NNG+를/JKO+,/SP
자녀세대는	자녀/NNG+세대/NNG+는/JX
1979~1992년(23~36살)	1979/SN+~/SO+1992/SN+년/NNB+(/SS+23/SN+~/SO+36/SN+살/NNB+)/SS
출생자를	출생자/NNG+를/JKO
각각	각각/MAG
뜻한다.	뜻/NNG+하/XSV+ㄴ다/EF+./SF


# id : NWRW1800000048.41.5.2
전경련 조사 결과 베이비붐 세대는 기업 고위임원(매출액 상위 10대기업 전무급 이상)의 79%, 정부 고위관료(청와대와 정부부처 차관급 이상)의 68%, 19대 국회의원의 44% 이상을 차지한다.

전경련	전경련/NNP
조사	조사/NNG
결과	결과/NNG
베이비붐	베이비붐/NNG
세대는	세대/NNG+는/JX
기업	기업/NNG
고위임원(매출액	고위/NNG+임원/NNG+(/SS+매출액/NNG
상위	상위/NNG
10대기업	10/SN+대/NNG+기업/NNG
전무급	전무급/NNG
이상)의	이상/NNG+)/SS+의/JKG
79%,	79/SN+%/SW+,/SP
정부	정부/NNG
고위관료(청와대와	고위/NNG+관료/NNG+(/SS+청와대/NNP+와/JC
정부부처	정부/NNG+부처/NNG
차관급	차관급/NNG
68%,	68/SN+%/SW+,/SP
19대	19/SN+대/NNB
국회의원의	국회/NNG+의원/NNG+의/JKG
44%	44/SN+%/SW
이상을	이상/NNG+을/JKO
차지한다.	차지/NNG+하/XSV+ㄴ다/EF+./SF


# id : NWRW1800000048.41.6.1
이 부회장은 “베이비붐 세대는 취업이 쉬웠지만 자녀세대는 이태백(이십대 태반이 백수), 인구론(인문대 졸업생 90%가 논다)이라는 신조어가 생길 정도로 어렵다”며 “창조경제와 규제개혁을 통해 새 일자리를 만들고, 임금피크제로 세대간 일자리 나누기를 해서 자녀세대에 일자리를 줘야 한다”고 주장했다.

이	이/NNP
부회장은	부회장/NNG+은/JX
“베이비붐	“/SS+베이비붐/NNG
세대는	세대/NNG+는/JX
취업이	취업/NNG+이/JKS
쉬웠지만	쉽/VA+었/EP+지만/EC
자녀세대는	자녀/NNG+세대/NNG+는/JX
이태백(이십대	이태백/NNG+(/SS+이십/NR+대/NNB
태반이	태반/NNG+이/JKS
백수),	백수/NNG+)/SS+,/SP
인구론(인문대	인구론/NNG+(/SS+인문대/NNG
졸업생	졸업/NNG+생/XSN
90%가	90/SN+%/SW+가/JKS
논다)이라는	놀/VV+ㄴ다/EF+)/SS+이/VCP+라는/ETM
신조어가	신조어/NNG+가/JKS
생길	생기/VV+ㄹ/ETM
정도로	정도/NNG+로/JKB
어렵다”며	어렵/VA+다/EF+”/SS+며/EC
“창조경제와	“/SS+창조/NNG+경제/NNG+와/JKB
규제개혁을	규제/NNG+개혁/NNG+을/JKO
통해	통하/VV+아/EC
새	새/MMA
일자리를	일자리/NNG+를/JKO
만들고,	만들/VV+고/EC+,/SP
임금피크제로	임금/NNG+피크/NNG+제/XSN+로/JKB
세대간	세대/NNG+간/NNB
일자리	일자리/NNG
나누기를	나누/VV+기/ETN+를/JKO
해서	하/VV+아서/EC
자녀세대에	자녀/NNG+세대/NNG+에/JKB
줘야	주/VV+어야/EC
한다”고	하/VX+ㄴ다/EF+”/SS+고/JKQ
주장했다.	주장/NNG+하/XSV+았/EP+다/EF+./SF


# id : NWRW1800000048.41.6.2
전경련은 한국이 경제협력개발기구(OECD) 평균 수준으로 규제완화를 하면 30만개 일자리가 만들어지고, 55살 이후 매년 10%씩 임금을 낮추는 임금피크제를 도입하면 31만3천개의 청년일자리가 만들어질 것으로 예상했다.

전경련은	전경련/NNP+은/JX
한국이	한국/NNP+이/JKS
경제협력개발기구(OECD)	경제협력개발기구/NNP+(/SS+OECD/SL+)/SS
평균	평균/NNG
수준으로	수준/NNG+으로/JKB
규제완화를	규제/NNG+완화/NNG+를/JKO
하면	하/VV+면/EC
30만개	30/SN+만/NR+개/NNB
일자리가	일자리/NNG+가/JKS
만들어지고,	만들/VV+어/EC+지/VX+고/EC+,/SP
55살	55/SN+살/NNB
이후	이후/NNG
매년	매년/MAG
10%씩	10/SN+%/SW+씩/XSN
임금을	임금/NNG+을/JKO
낮추는	낮추/VV+는/ETM
임금피크제를	임금/NNG+피크/NNG+제/XSN+를/JKO
도입하면	도입/NNG+하/XSV+면/EC
31만3천개의	31/SN+만/NR+3/SN+천/NR+개/NNB+의/JKG
청년일자리가	청년/NNG+일자리/NNG+가/JKS
만들어질	만들/VV+어/EC+지/VX+ㄹ/ETM
것으로	것/NNB+으로/JKB
예상했다.	예상/NNG+하/XSV+았/EP+다/EF+./SF


# id : NWRW1800000048.41.7.1
이 부회장은 또 자녀세대의 자산 형성을 돕기 위해 장기적 경제성장책으로 잠재성장률을 높이고, 자녀세대의 노후보장을 위해 국내총생산(GDP) 대비 국가채무 비중을 현 수준으로 묶는 ‘국가채무상한제’와, 연금을 자기세대가 납부한 만큼만 받아가는 ‘세대별 독립채산제’를 주장했다.

이	이/NNP
부회장은	부회장/NNG+은/JX
또	또/MAG
자녀세대의	자녀/NNG+세대/NNG+의/JKG
자산	자산/NNG
형성을	형성/NNG+을/JKO
돕기	돕/VV+기/ETN
위해	위하/VV+아/EC
장기적	장기/NNG+적/XSN
경제성장책으로	경제/NNG+성장책/NNG+으로/JKB
잠재성장률을	잠재/NNG+성장/NNG+률/XSN+을/JKO
높이고,	높이/VV+고/EC+,/SP
노후보장을	노후/NNG+보장/NNG+을/JKO
국내총생산(GDP)	국내/NNG+총생산/NNG+(/SS+GDP/SL+)/SS
대비	대비/NNG
국가채무	국가/NNG+채무/NNG
비중을	비중/NNG+을/JKO
현	현/MMD
수준으로	수준/NNG+으로/JKB
묶는	묶/VV+는/ETM
‘국가채무상한제’와,	‘/SS+국가/NNG+채무/NNG+상한/NNG+제/XSN+’/SS+와/JC+,/SP
연금을	연금/NNG+을/JKO
자기세대가	자기/NNG+세대/NNG+가/JKS
납부한	납부/NNG+하/XSV+ㄴ/ETM
만큼만	만큼/NNB+만/JX
받아가는	받/VV+아/EC+가/VX+는/ETM
‘세대별	‘/SS+세대/NNG+별/XSN
독립채산제’를	독립/NNG+채산/NNG+제/XSN+’/SS+를/JKO
주장했다.	주장/NNG+하/XSV+았/EP+다/EF+./SF


# id : NWRW1800000048.41.8.1
상의는 ‘청년실업 전망과 대책’ 보고서에서 “20년 전 대학문턱을 낮췄던 근시안적 정원자율화정책이 대졸자 공급과잉이라는 부메랑으로 돌아왔다”면서 “학벌중시사회의 대학진학수요에 맞춰진 교육제도를 산업계 수요에 맞게 개혁하고, 정년연장의 문제를 보완해야 한다”고 말했다.

상의는	상의/NNP+는/JX
‘청년실업	‘/SS+청년/NNG+실업/NNG
전망과	전망/NNG+과/JC
대책’	대책/NNG+’/SS
보고서에서	보고서/NNG+에서/JKB
“20년	“/SS+20/SN+년/NNB
전	전/NNG
대학문턱을	대학/NNG+문턱/NNG+을/JKO
낮췄던	낮추/VV+었/EP+던/ETM
근시안적	근시안/NNG+적/XSN
정원자율화정책이	정원/NNG+자율/NNG+화/XSN+정책/NNG+이/JKS
대졸자	대졸자/NNG
공급과잉이라는	공급/NNG+과잉/NNG+이/VCP+라는/ETM
부메랑으로	부메랑/NNG+으로/JKB
돌아왔다”면서	돌아오/VV+았/EP+다/EF+”/SS+면서/EC
“학벌중시사회의	“/SS+학벌/NNG+중시/NNG+사회/NNG+의/JKG
대학진학수요에	대학/NNG+진학/NNG+수요/NNG+에/JKB
맞춰진	맞추/VV+어/EC+지/VX+ㄴ/ETM
교육제도를	교육/NNG+제도/NNG+를/JKO
산업계	산업/NNG+계/XSN
수요에	수요/NNG+에/JKB
맞게	맞/VV+게/EC
개혁하고,	개혁/NNG+하/XSV+고/EC+,/SP
정년연장의	정년/NNG+연장/NNG+의/JKG
문제를	문제/NNG+를/JKO
보완해야	보완/NNG+하/XSV+아야/EC
한다”고	하/VX+ㄴ다/EF+”/SS+고/JKQ
말했다.	말/NNG+하/XSV+았/EP+다/EF+./SF


# id : NWRW1800000048.41.8.2
상의는 대학진학 목적의 조기교육 대신 독일과 스위스와 같은 조기 진로지도 도입, 인문계-이공계 대졸자간 수급 괴리 해소, 임금피크제 조기정착 등의 대안을 제시했다.

상의는	상의/NNP+는/JX
대학진학	대학/NNG+진학/NNG
목적의	목적/NNG+의/JKG
조기교육	조기/NNG+교육/NNG
대신	대신/NNG
독일과	독일/NNP+과/JC
스위스와	스위스/NNP+와/JKB
같은	같/VA+은/ETM
조기	조기/NNG
진로지도	진로/NNG+지도/NNG
도입,	도입/NNG+,/SP
인문계-이공계	인문/NNG+계/XSN+-/SO+이공/NNG+계/XSN
대졸자간	대졸자/NNG+간/NNB
수급	수급/NNG
괴리	괴리/NNG
해소,	해소/NNG+,/SP
임금피크제	임금/NNG+피크/NNG+제/XSN
조기정착	조기/NNG+정착/NNG
등의	등/NNB+의/JKG
대안을	대안/NNG+을/JKO
제시했다.	제시/NNG+하/XSV+았/EP+다/EF+./SF


